12:12
17 50  18 0  0   0   0    0   0  0  0   0
17 0   0  0  17  18  17   17  17 17 17  32
0  17  18 18 66  18  0    0   0  0  0   0 
0  0   0  0  0   18  0    0   0  0  0   0 
32 32  18 18 18  18  18   18  18 18 32  32
0  0   0  0  0   0   0    0   0  0  0   0 
0  0   0  0  0   0   0    0   0  0  0   0 
18 18  32 17 0   17  17   17  17 17 17  17
17 18  17 17 0   0   0    0   0  0  0   0
0  0   0  51 17  17  17   17  17 17 32  32
0  17  17 17 0   0   0    0   0  0  0   0
32 0   0  0  0   0   0    0   0  0  0   0