12:12
57  17 0   0  0  35 0  0  0  0  0  0
0   0  0   0  0  35 0  0  0  0  0  0 
0   0  18  18 18 18 18 18 18 18 0  0
35  35 18  0  0  0  0  0  0  18 35 35 
0   0  18  0  0  0  0  0  0  18 0  0 
0   0  18  0  0  18 18 18 0  18 0  0 
0   0  18  0  18 20 0  0  0  18 0  0 
35  35 18  0  0  18 18 0  0  18 35 35 
0   0  18  0  0  0  18 18 18 18 0  0  
0   0  18  18 22 18 18 18 18 18 0  0 
0   0  0   0  0  18 72 0  0  0  0  0 
0   0  0   0  0  18 0  0  0  0  0  0 