12:12
17  17 17 54 17  18  70 0  0   0   0   0
0   0  0  0  0   18  0  0  0   0   0   0 
0   0  0  0  0   18  0  0  0   0   0   0 
35  18 18 18 18  18  18 18 18  18  18  35 
0   0  0  0  0   0   0  0  0   0   0   0 
0   0  0  0  0   35  0  0  0   0   0   0 
0   0  0  0  0   0   0  0  0   0   0   0 
35  18 18 18 18  18  18 18 18  18  18  18 
0   0  0  0  0   18  0  0  0   17  55  17  
0   0  0  0  0   32  0  0  0   0   0   0 
0   0  0  0  0   32  0  0  0   0   17  0 
0   0  0  0  0   18  0  0  17  17  17  0 