12:12
0 0 0 0 0 0 0 0 0 0 0 0 
0 0 0 0 0 0 0 0 0 0 0 0 
17 17 17 17 17 17 17 17 17 17 32 32
0 0 0 0 0 0 0 0 0 0 0 0 
0 0 0 0 0 0 0 0 0 0 0 0  
32 32 17 17 17 17 17 17 17 17 17 17
0 0 0 0 0 32 32 0 0 0 0 0 
0 0 0 0 0 0 0 0 0 0 0 0  
18 18 18 18 18 18 18 18 18 18 32 32 
17 48 17 64 17 17 0 0 0 0 0 0 
17 0 17 0 0 17 17 0 0 17 17 0
0 0 0 32 0 0 0 0 0 0 0 0                                                                                                                                                                                    
