12:12 
17  0  17  0  0  35  0   0  17 68  0 0
17  0  0   17 0  17  17  0  17 18 18 0
53  17 0   17 0  17  18  0  0  0  0  0
0   0  0   17 0  17  18  18 18 18 18 18
0   17 17  0  0  35  0   0  0  0  0  0 
32  17 17  0  17 17  18  0  0  0  0  0 
0   0  17  0  0  18  18  18 18 18 18 0 
0   0  17  0  0  18  0   0  0  0  0  0
0   0  17  0  0  18  0   0  0  0  0  0 
17  0  17  0  0  18  0   18 18 18 18 18 
0   0  17  0  0  18  0   0  0  0  0  0 
0   0  32  0  0  18  0   0  0  0  18 52 